old_favorite 12 12 11 11 0 0 
0 0 0 0 0 0 0 0 0 0 0 0  0 0 0 0 0 0 0 0 0 0 0 0
0 0 0 0 0 0 0 0 1 0 1 0  1 0 1 0 0 0 0 0 0 0 0 0
0 0 0 0 0 0 1 0 1 1 1 1  1 1 1 1 1 0 0 0 0 0 0 0
0 0 0 0 1 0 7 1 1 3 1 3  1 3 1 3 7 3 1 0 0 0 0 0
0 0 4 0 1 1 1 3 2 0 2 0  2 0 2 0 1 3 1 1 4 0 0 0
0 0 4 0 1 1 1 3 2 0 2 0  2 0 2 0 1 3 1 1 4 0 0 0
0 0 4 0 1 1 1 3 2 0 2 0  2 0 2 0 1 3 1 1 4 0 0 0
0 0 4 0 1 1 1 3 2 0 2 0  2 0 2 0 1 3 1 1 4 0 0 0
0 0 0 0 1 0 7 3 1 3 1 3  1 3 1 3 7 1 1 0 0 0 0 0
0 0 0 0 0 0 1 0 1 1 1 1  1 1 1 1 1 0 0 0 0 0 0 0
0 0 0 0 0 0 0 0 1 0 1 0  1 0 1 0 0 0 0 0 0 0 0 0
0 0 0 0 0 0 0 0 0 0 0 0  0 0 0 0 0 0 0 0 0 0 0 0
