simpleton 12 12 11 11 0 0 
4 0 0 0 0 0 0 0 0 0 1 2  1 2 0 0 0 0 0 0 0 0 4 0
8 0 0 0 0 0 0 0 8 0 1 3  1 3 8 0 0 0 0 0 0 0 8 0
0 0 0 0 0 0 2 0 1 3 1 3  1 3 1 3 2 0 0 0 0 0 0 0
0 0 7 2 2 0 1 1 1 1 1 1  1 1 1 1 1 1 2 0 7 1 0 0
0 0 8 0 1 0 1 0 0 0 0 0  0 0 0 0 1 0 1 0 8 0 0 0
0 0 0 0 0 0 0 0 0 0 2 0  2 0 0 0 0 0 0 0 0 0 0 0
0 0 0 0 0 0 0 0 0 0 2 0  2 0 0 0 0 0 0 0 0 0 0 0
0 0 8 0 1 0 1 0 0 0 0 0  0 0 0 0 1 0 1 0 8 0 0 0
0 0 7 3 2 0 1 3 1 3 1 3  1 3 1 3 1 3 2 0 7 4 0 0
0 0 0 0 0 0 2 0 1 1 1 1  1 1 1 1 2 0 0 0 0 0 0 0
0 0 0 0 0 0 0 0 8 0 1 1  1 1 8 0 0 0 0 0 0 0 0 0
0 0 0 0 0 0 0 0 0 0 1 4  1 4 0 0 0 0 0 0 0 0 0 0
